NO ./assets/textures/north.xpm
SO ./assets/textures/south.xpm
WE ./assets/textures/west.xpm
EA ./assets/textures/east.xpm
F 220,100,0
C 225,30,0

11111111111111111111111111111111111111111111111111111111111111111111111111111111111111111111111111
10000000000000000011111111111111100000000000000001111111111111110000000000000000111111111111111001
10111111111111111010000000000000101111111111111010000000000000101111111111111010000000000000101001
10100000000000001010111111111110101000000000001010111111111110101000000000001010111111111110101001
10101111111111101010100000000010101011111111101010100000000010101011111111101010100000000010101001
10101000000000101010101111111010101010000000101010101111111010101010000000101010101111111010101001
10101011111110101010101000001010101010111110101010101000001010101010111110101010101000001010101001
10101010000010101010101011101010101010100010101010101011101010101010100010101010101011101010101001
10101010111010101010101010101010101010101010101010101010101010101010101010101010101010101010101001
10101010101010101010101010101010101010101010101010S010101010101010101010101010101010101010101001
10101010101110101010101010101010101010101110101010101010101010101010101110101010101010101010101001
10101010001110101010101010111010101010001110101010101010111010101010001110101010101010111010101001
10101011101110101010101010111010101011101110101010101010111010101011101110101010101010111010101001
10101011101110101010101110111010101011101110101010101110111010101011101110101010101110111010101001
10101011101110101010101110111010101011101110101010101110111010101011101110101010101110111010101001
10101011101110101010111110111010101011101110101010111110111010101011101110101010111110111010101001
10101011101110101010111110111010101011101110101010111110111010101011101110101010111110111010101001
10101011101110101010111110111010101011101110101010111110111010101011101110101010111110111010101001
10101000001110101000111110111010101000001110101000111110111010101000001110101000111110111010101001
10111111111110111111111110111011111111111110111111111110111011111111111110111111111110111011111001
10000000000000000000000000000000000000000000000000000000000000000000000000000000000000000000000001
11111111111111111111111111111111111111111111111111111111111111111111111111111111111111111111111111
