11111111111111111111111111111111
10000000000000000000000000000001
10000000000110000001100000000001
10000000001111000011110000000001
10000000000110000001100000000001
10000000000000000000000000000001
10001100000000X00000000000110001
10011110000000000000000001111001
10001100000000000000000000110001
10000000000000000000000000000001
10000000000000N00000000000000001
10000000000000000000000000000001
10000000000000000000000000000001
11111111111111111111111111111111
