NO assets/textures/north.xpm
SO assets/textures/south.xpm
WE assets/textures/west.xpm
EA assets/textures/east.xpm

C 10,10,10
F 125,255,64

11111
10001
10S01
10001
11111