NO assets/textures/cub3_north.xpm
SO assets/textures/cub3_south.xpm
WE assets/textures/cub3_west.xpm
EA assets/textures/cub3_east.xpm

F 220,100,0
C 225,30,0
 111111111111111 
10000000100000001
10000000100000001
10000000100000001
100000001000000001
10000000000000001
10000000000000001
10000000000000001
11000000N00001111
10000000000000001
10000000000000001
10000000000000001
100000000000000001
10000000000000001
10000000100000001
10000000100000001
 111111111111111