NO assets/textures/cub3_north.xpm
SO assets/textures/cub3_south.xpm
WE assets/textures/cub3_west.xpm
EA assets/textures/cub3_east.xpm
F 220,100,0
C 225,30,0
11111111111111111111111111
10000000000000000000000001
10001111111111111111100001
1001                 11001
1001  1  1    1111   11001
1001  1  1       1   10001
1001  1111    1111   10001
10001    1    1      10001
10001    1    1111   10001
10001                10001
10001111111111111111100001
10000000000000000000000001
1111111S111111111111111111
       11