NO assets/textures/cub3_north.xpm
SO assets/textures/cub3_south.xpm
WE assets/textures/cub3_west.xpm
EA assets/textures/cub3_east.xpm
F 125,96,64
C 225,30,01
1111111111111111111111111111111111111111111
1100000000000000000000000000000000000000011
1100000000000000000000000000000000000000011
1100000000000000000000000000000000000000101
1010000000000000000000000000000000000000101
1010000000000000000000000000000000000001001
1001000000000000000000000000000000000001001
1001000000000000000000000000000000000010001
1000100000000000000000000000000000000010001
1000100000000000000000000000000000000100001
1000010000000000000000000000000000000100001
1000010000000000000000000000000000001000001
1000001000000000000000000000000000001000001
1000001000000000000000000000000000010000001
1000000100000000000000000000000000010000001
1000000100000000000000000000000000100000001
1000000010000000000000000000000000100000001
1000000010000000000000000000000001000000001
1000000001000000000000000000000001000000001
1000000001000000000000000000000010000000001
1000000000100000000000000000000010000000001
1000000000100000000000000000000100000000001
1000000000010000000000000000000100000000001
1000000000010000000000000000001000000000001
1000000000001000000000000000001000000001001
1000000000001000000000000000010000000000001
1000000000000100000000000000010000000000001
1000000000000100000000000000100000000000001
1000000000000010000000000000100000000000001
1000000000000010000000000001000000000000001
1000000000000001000000000001000000000000001
1000000000000001000000000001000000000000001
1000000000000000100000000010000000000000001
1000000000000000100000000010000000000000001
1000000000000000010000000100000000000000001
1000000000000000010000000100000000000000001
1000000000000000001000001000000000000000001
1000000000000000001000001000000000000000001
1000000000000000000100010000000000000000001
1000000000000000000100010000000000000000001
1000000000000000000010100000000000000000001
1000000000000000000000000000000000000000001
100000000000000000000N000000000000000000001
1000000000000000000000000000000000000000001
1000000000000000000000000000000000000000001
1000000000000000000000000000000000000000001
1000000000000000000000000000000000000000001
1000000000000000000000000000000000000000001
1000000000000000000000000000000000000000001
1000000000000000000000000000000000000000001
1000000000000000000000000000000000000000001
1000000000000000000000000000000000000000001
1000000000000000000000000000000000000000001
1000000000000000000000000000000000000000001
1000000000000000000000000000000000000000001
1000000000000000000000000000000000000000001
1000000000000000000000000000000000000000001
1000000000000000000000000000000000000000001
1000000000000000000000000000000000000000001
1000000000000000000000000000000000000000001
1000000000000000000000000000000000000000001
1000000000000000000000000000000000000000001
1000000000000000000000000000000000000000001
1000000000000000000000000000000000000000001
1000000000000000000000000000000000000000001
1000000000000000000000000000000000000000001
1000000000000000000000000000000000000000001
1000000000000000000000000000000000000000001
1000000000000000000000000000000000000000001
1000000000000000000000000000000000000000001
1000000000000000000000000000000000000000001
1000000000000000000000000000000000000000001
1000000000000000000000000000000000000000001
1000000000000000000000000000000000000000001
1000000000000000000000000000000000000000001
1000000000000000000000000000000000000000001
1000000000000000000000000000000000000000001
1000000000000000000000000000000000000000001
1000000000000000000000000000000000000000001
1000000000000000000000000000000000000000001
1000000000000000000000000000000000000000001
1000000000000000000000000000000000000000001
1000000000000000000000000000000000000000001
1111111111111111111111111111111111111111111