NO   assets/textures/cub3_north.xpm
SO   assets/textures/cub3_south.xpm
WE   assets/textures/cub3_west.xpm
EA   assets/textures/cub3_east.xpm

F   255,  255,  255
C   0,  100,  200
111111111
100000001
1000N0001
100000001
111111111
