NO assets/wall/north.xpm
SO assets/wall/south.xpm
WE assets/wall/west.xpm
EA assets/wall/east.xpm
F 220,100,0
C 225,30,0
111111111
10000000
10000000
1000N000
10000000
10000000
111111111