NO ./assets/textures/north.xpm
SO ./assets/textures/south.xpm
WE ./assets/textures/west.xpm
EA ./assets/textures/east.xpm
F 220,100,0
C 225,30,0

11111
10E01
10W01
10001
11111
