NO ./assets/textures/cub3_north.xpm
SO ./assets/textures/cub3_south.xpm
WE ./assets/textures/cub3_west.xpm
EA ./assets/textures/cub3_east.xpm
F 220,100,0
C 225,30,0

11111
10S01
10E01
10001
11111
