NO ./assets/textures/cub3_north.xpm
SO ./assets/textures/cub3_south.xpm
WE ./assets/textures/cub3_west.xpm
EA ./assets/textures/cub3_east.xpm
F 220,100,0
C 225,30

11111
10001
10N01
10001
11111
