NO ./assets/textures/cub3_north.xpm
SO ./assets/textures/cub3_south.xpm
WE ./assets/textures/cub3_west.xpm
EA ./assets/textures/cub3_east.xpm
F 220,100,0
C 225,30,0

  1   1   1   1   1
 111 111 111 111 111
11111111111111111111
10000000000000000001
11100000000000000111
  10000000000000001
  11000000000000011
   1000000N0000001
  11000000000000011
  10000000000000001
11100000000000000111
10000000000000000001
11111111111111111111
 111 111 111 111 111
  1   1   1   1   1
