NO ./assets/textures/cub3_north.xpm
SO ./assets/textures/cub3_south.xpm
WE ./assets/textures/cub3_west.xpm
EA ./assets/textures/cub3_east.xpm
F 220,100,0
C 225,30,0

1111111111111111111
1000001000001000001
1011101011101011101
1010001010001010001
1010111010111010101
1010100010100010101
1010101110101110101
1010100000101000101
1010101110101010101
1010100010101010101
1010111110101010101
1010000000101010101
1011111111101010101
1000000000001010001
101111111111101N101
1000000000000010001
1111111111111111111
